


 --- --- --- --- --- --- --- --- --- --- --- ---
| O | Q | L | O | N | Q | J | M | H | L | Q | U |
|---|---|---|---|---|---|---|---|---|---|---|---|
| W | V | G | V | Q | J | B | B | I | F | T | A |
|---|---|---|---|---|---|---|---|---|---|---|---|
| A | P | Z | M | G | W | I | P | W | M | R | E = End
|---|---|---|---|---|---|---|---|---|---|---|---|
| L | G | I | T | R | G | M | B | I | X | N | Z |
|---|---|---|---|---|---|---|---|---|---|---|---|
| I | B | V | Y | E | K | Z | G | A | F | H | A |
|---|---|---|---|---|---|---|---|---|---|---|---|
| Q | L | K | Y | S | O | C | G | X | N | T | M |
|---|---|---|---|---|---|---|---|---|---|---|---|
| N | L | P | J | K | M | N | P | W | O | Y | D |
|---|---|---|---|---|---|---|---|---|---|---|---|
| Q | R | P | T | S | J | C | P | J | D | I | R |
|---|---|---|---|---|---|---|---|---|---|---|---|
| Q | C | Q | V | Y | S | M | W | I | V | N | O |
|---|---|---|---|---|---|---|---|---|---|---|---|
| M | P | J | D | D | N | W | N | I | S | I | W |
|---|---|---|---|---|---|---|---|---|---|---|---|
| A | E | T | A | R | E | N | E | G | O | T | M |
|---|---|---|---|---|---|---|---|---|---|---|---|
| U | A | E | Z | A | M | D | R | O | W | M | A |
 | | --- --- --- --- --- --- --- --- --- --- ---
Start


